1111111111111111111111111111111111
10000C10000000100000C00000000001E1
1001111111101010111111001111111101
1000000000101010100001C00010000001
11111100001110101010C1111110000001
1C001000001C1010101111001000111001
111011010010100000100000100C100001
1C10000100100000001011001111100001
10111101001110000000C1001000000001
1010000100100001111111100000000001
1010010100100100000101001111111001
100001C100000100000000000100001001
1011111111111101111111101101111001
100000000000000000100000C100000001
1011111111010111001011110111101001
101C00000101010C0000000101C01C1101
1P10000000010100000000010110000001
1111111111111111111111111111111111
