1111111111111111111111111111111111
100C0000000000000C0C0000C000000001
1011111111111111111111111111111101
1C1000C00C0000000000C0000C00000101
101C111111111111111111111111110101
10101000C000000000C0000C00000001C1
101C1E00010C000000C0000000000C0101
1010111111111111111111111111111101
1C100000000C0000C000C000C0000000C1
1011111111111111111111111111111111
1C00000C00000000000000000000C00001
1111111111111111111111111111111101
10000C000C000C0000C000000000000001
1011111111111111111111111111111111
1000000C00000000C000000000C0000001
1111111111111111111111111111111101
100P000000CCCCCCCC0000000000000001
1111111111111111111111111111111111
