1111111111111111111111
1000000000000000000001
1E010000C0000000000001
11110CCC00000000000001
1000P00000000000000001
1111111111111111111111
